明	Aki	Mei	Bright
顯	Aki	Ken	Manifest
有	Ari	Yū	Possess
有	Ara	Yū	Possess
有	Nao	Yū	Possess
郭	Hiro	Kaku	Fortification
敦	Atsu	Ton	Kindly
親	Chika	Shin	Near
房	Fusa	Bō	Tassel
春	Haru	Shun	Spring
治	Hari	Ji	Govern
晴	Haru	Sei	Clear
秀	Hide	Shū	Excellent
英	Hide	Ei	Heroic
彦	Hiko	Gen	Prince
衡	Hira	Kō	Measure
平	Taira	Hei	Peace
平	Hira	Hei	Peace
弘	Hiro	Kō	Wide
久	Hisa	Kyū	Longtime
家	Ie	Ka	House
景	Kage	Kei	View
兼	Kane	Ken	Concurrent
片	Kata	Hen	One-side
方	Kata	Hō	Direction
賢	Kata	Ken	Wisdom
勝	Katsu	Shō	Victory
一	Kazu	Ichi	One
和	Kazu	Wa	Harmony
清	Kiyo	Sei	Pure
伊	Kore	I	This
是	Kore	Ze	This
惟	Kore	I	Consider
國	Kuni	Koku	Country
国	Kuni	Koku	Country
政	Masa	Sei	Political
正	Masa	Sei	Upright
昌	Masa	Shō	Prosperous
雅	Masa	Ga	Elegant
道	Michi	Dō	Way
通	Michi	Tsū	Path
光	Mitsu	Kō	Shining
満	Mitsu	Man	Full
持	Mochi	Ji	Hold
盛	Mori	Sei	Flourishing
守	Mori	Shu	Protect
師	Moro	Shi	Master
元	Moto	Gen	Original
基	Moto	Ki	Foundation
宗	Mune	Shū	Sect
長	Naga	Chō	Long
永	Naga	Ei	Eternity
仲	Naka	Chū	Friendship
直	Nao	Choku	Honest
成	Nari	Sei	Become
業	Nari	Gyō	Vocation
信	Nobu	Shin	Faith
宣	Nobu	Sen	Proclaim
教	Nori	Kyō	Teach
憲	Nori	Ken	Law
定	Sada	Tei	Establish
貞	Sada	Tei	Virtuous
実	Sane	Jitsu	Truth
重	Shige	Jū	Important
茂	Shige	Mo	Luxuriant
季	Sue	Ki	Season
助	Suke	Jo	Assist
忠	Tada	Chū	Loyal
直	Tada	Choku	Straight
高	Taka	Kō	High
孝	Taka	Kō	Filial Piety
武	Take	Bu	Martial
為	Tame	I	Benefit
胤	Tane	In	Offspring
輝	Teru	Ki	Shining
時	Toki	Ji	Time
朝	Tomo	Chō	Dynasty
具	Tomo	Gu	Tool
俊	Toshi	Shun	Excellence
敏	Toshi	Bin	Alert
利	Toshi	Ri	Benefit
常	Tsune	Jō	Normal
経	Tsune	Kei	Sutra
内	Uchi	Nai	Inner
氏	Uji	Shi	Clan
康	Yasu	Kō	Peace
安	Yasu	An	Peace
泰	Yasu	Tai	Peaceful
頼	Yori	Rai	Rely
良	Yoshi	Ryō	Good
義	Yoshi	Gi	Righteousness
行	Yuki	Kō	Journey
吉	Yoshi	Kichi	Good Luck
幸	Yuki	Kō	Fortune
之	Yuki	Shi	This